2
4
3 1
22 22
0 0 0 0 0 0 0 0 0 0 0 0 0 0 0 0 0 0 0 0 0 0
0 0 0 0 0 0 0 0 0 0 0 0 0 x 0 0 0 0 0 0 0 0
0 0 0 0 0 0 0 0 0 0 0 0 0 0 0 0 0 0 0 0 0 0
0 0 0 x - - 0 0 0 0 0 0 0 0 0 0 - - 0 0 0 0
0 0 0 0 - 0 - - - - 0 0 - - - - 0 - 0 0 0 0
0 0 0 0 0 - - - - - 0 0 - - - - - 0 0 0 0 0
0 0 0 0 0 - - - 0 0 0 0 0 0 - - - 0 0 0 0 0
0 0 x 0 0 - - 0 0 0 0 0 0 0 0 - - 0 x 0 0 0
0 0 0 0 0 - - 0 x 0 - - 0 0 0 - - 0 0 0 0 0
0 0 0 0 0 - - 0 0 0 - - 0 0 0 - - 0 0 0 0 0
0 0 0 0 0 1 2 0 0 - - - - 0 0 2 1 0 0 0 0 0
0 0 0 0 0 2 1 0 0 - - - - 0 0 1 2 0 0 x 0 0
0 0 0 0 0 - - 0 0 0 - - 0 0 0 - - 0 0 0 0 0
0 0 0 0 0 - - 0 0 0 - - 0 0 0 - - b 0 0 0 0
0 0 0 x 0 - - 0 0 0 0 0 x 0 0 - - 0 0 0 0 0
0 0 0 0 0 - - - 0 0 0 0 0 0 - - - 0 0 0 0 0
0 0 0 0 0 - - - - - 0 0 - - - - - 0 0 0 0 0
0 0 0 0 - 0 - - - - 0 0 - - - - 0 - 0 0 0 0
0 0 0 0 - - 0 0 0 0 0 0 0 0 0 0 - - 0 0 0 0
0 0 0 0 0 0 0 x 0 0 2 1 0 0 0 0 0 0 0 0 0 0
0 0 0 0 0 0 0 0 0 0 1 2 0 0 0 0 0 0 0 x 0 0
0 0 0 0 0 0 0 0 0 0 0 0 0 0 0 0 0 0 0 0 0 0
0 0 7 <-> 21 21 3
21 0 1 <-> 0 21 5
9 9 3 <-> 5 4 3 
12 12 7 <-> 16 17 7
9 12 1 <-> 5 17 1
12 9 5 <-> 16 4 5
3 2 3 <-> 18 19 7
3 19 1 <-> 18 2 5