2
0
0 0
5 5
1 0 1 0 1
0 2 2 2 0
1 2 i 2 1
0 2 2 2 0
1 0 1 0 1