8
3
1 1
25 30
- - - 0 0 0 0 0 0 0 0 0 0 0 0 0 0 0 0 0 0 0 0 0 0 0 0 - - -
- - - 0 0 0 0 0 0 0 0 0 0 0 0 0 0 0 0 0 0 0 0 0 0 0 0 - - -
- - - 0 0 0 0 0 0 0 0 0 0 0 0 0 0 0 0 0 0 0 0 0 0 0 0 - - -
- - - 0 0 0 0 0 0 0 0 0 0 0 0 0 0 0 0 0 0 0 0 0 0 0 0 - - -
- - - 0 0 0 0 - - - - - - - - - - - - - - - - 0 0 0 0 - - -
- - - 0 0 0 0 - - - - - - - x - - - - - - - - 0 0 0 0 - - -
- - - 0 0 0 0 - - - - - - - x - - - - - - - - 0 0 0 0 - - -
- - - 0 0 0 0 - - - - - 0 0 0 0 0 - - - - - - 0 0 0 0 - - -
- - - 0 0 0 0 - - - - 0 1 2 0 0 0 0 - - - - - 0 0 0 0 - - -
- - - 0 0 0 0 - - - 0 0 3 4 0 0 - - - - - - - 0 0 0 0 - - -
- - - 0 0 0 0 - - - 0 0 0 0 0 0 - - - - - - - 0 0 0 0 - - -
- - - 0 0 0 0 - - - 0 0 0 0 0 0 - - - - - - - 0 0 0 0 - - -
- - - 0 0 0 0 - - - 0 0 0 0 0 0 0 0 - - - - - 0 0 0 0 - - -
- - - 0 0 0 0 - - - 0 0 5 6 0 0 0 0 - - - - - 0 0 0 0 - - -
- - - 0 0 0 0 - - - 0 0 7 8 0 0 0 0 - - - - - 0 0 0 0 - - -
- - - 0 0 0 0 - - - 0 0 0 0 0 0 0 0 - - - - - 0 0 0 0 - - -
- - - 0 0 0 0 - - - - 0 0 0 0 0 0 0 - - - - - 0 0 0 0 - - -
- - - 0 0 0 0 - - - - x - - - - - x - - - - - 0 0 0 0 - - -
- - - 0 0 0 0 0 0 0 0 0 0 0 0 0 0 0 0 0 0 0 0 0 0 0 0 - - -
- - - 0 0 0 0 0 0 5 8 0 0 0 0 0 0 0 0 0 7 8 0 0 0 0 0 - - -
- - - 0 0 0 0 0 0 7 6 0 0 0 0 0 0 0 0 0 6 5 0 0 0 0 0 - - -
- - - 0 0 0 2 3 0 0 0 0 0 0 5 6 0 1 4 0 0 0 0 0 0 0 0 - - -
- - 0 0 0 0 1 4 0 0 0 0 0 0 7 8 0 2 3 0 0 0 0 0 0 0 0 0 - -
- 0 0 0 0 0 0 0 0 0 0 0 0 0 0 0 0 0 0 0 0 0 0 0 1 2 0 0 0 -
0 0 0 0 0 0 0 0 0 0 0 0 0 0 0 0 0 0 0 0 0 0 0 0 3 4 0 0 0 0
14 5 0 <-> 14 0 0
0 24 6 <-> 29 24 2 
5 24 4 <-> 5 0 0
8 24 4 <-> 8 0 0
11 24 4 <-> 11 0 0
17 24 4 <-> 17 0 0
21 24 4 <-> 21 0 0
26 24 4 <-> 26 0 0
3 5 6 <-> 26 5 2
3 8 6 <-> 26 8 2
3 13 6 <-> 26 13 2
3 17 6 <-> 26 17 2
3 21 6 <-> 26 21 2