4
2
4 2
30 30
- - - - 0 0 0 0 0 0 0 0 0 0 0 0 0 0 0 0 0 0 0 0 0 0 - - - -
- - 0 0 0 0 0 0 0 0 0 0 0 0 0 0 0 0 0 0 0 0 0 0 0 0 0 0 - -
- 0 0 0 0 0 0 0 0 0 0 0 0 0 0 0 0 0 0 0 0 0 0 0 0 0 0 0 0 -
- 0 0 0 0 0 0 0 0 x 0 0 0 0 0 0 0 0 0 c 0 0 0 0 0 0 0 0 0 -
0 0 0 0 0 0 0 0 0 0 0 0 0 0 - - 0 0 0 0 0 0 0 0 0 0 0 0 0 0
0 0 0 0 0 0 0 0 0 0 0 0 0 0 - - 0 0 0 0 0 0 0 x 0 0 0 0 0 0
0 0 0 0 0 0 0 0 0 0 0 0 0 - - - - 0 0 0 0 0 0 0 0 0 0 0 0 0
0 0 0 0 x 0 0 0 c 0 0 0 0 - - - - 0 0 0 0 0 0 0 0 0 0 0 0 0
0 0 0 0 0 0 0 0 0 0 0 0 0 - - - - 0 0 0 0 0 0 0 0 0 0 0 0 0
0 0 0 0 0 0 0 0 0 0 0 0 0 - - - - 0 0 0 0 0 0 0 0 0 x 0 0 0
0 0 0 0 0 0 0 0 0 4 3 0 0 0 - - 0 0 0 0 0 0 0 0 0 0 0 0 0 0
0 0 0 0 0 0 0 0 0 3 4 0 0 0 - - 0 0 0 0 0 0 0 0 0 0 0 0 0 0
0 0 0 0 - - - - 0 0 0 0 0 0 0 0 0 0 0 0 0 0 - - - - 0 0 0 0
0 0 0 0 - - - - 0 0 0 0 0 0 0 0 0 0 0 0 0 0 - - - - 0 0 0 0
0 0 0 0 - - - - 0 0 0 0 0 0 0 0 0 0 0 0 0 0 - - - - 0 0 0 0
0 0 0 0 - - - - 0 0 0 0 0 0 0 0 0 0 0 0 0 0 - - - - 0 0 0 0
0 0 0 0 - - - - 0 0 0 0 0 0 0 0 0 0 0 0 0 0 - - - - 0 0 0 0
0 0 0 0 - - - - 0 0 0 0 0 0 0 0 0 0 0 0 0 0 - - - - 0 0 0 0
0 0 0 0 0 0 0 0 0 0 0 0 0 0 - - 0 0 0 1 2 0 0 0 0 0 0 0 0 0
0 0 0 0 0 0 0 0 0 0 0 0 0 0 - - 0 0 0 2 1 0 0 0 0 0 0 0 0 0
0 0 0 0 0 0 0 0 0 0 0 0 0 - - - - 0 0 0 0 0 0 0 0 0 0 x 0 0
0 0 0 0 0 0 0 0 0 0 0 0 0 - - - - 0 0 0 0 0 0 0 0 0 0 0 0 0
0 0 0 0 0 0 0 0 0 0 0 0 0 - - - - 0 0 0 0 0 0 0 0 0 0 0 0 0
0 0 0 0 0 0 x 0 0 0 0 0 0 - - - - 0 0 0 0 0 0 0 0 0 0 0 0 0
0 0 0 0 0 0 0 0 0 0 0 0 0 0 - - 0 0 0 0 0 0 0 0 0 0 0 0 0 0
0 0 0 0 0 0 0 0 0 0 0 0 0 0 - - 0 0 0 0 0 0 0 x 0 0 0 0 0 0
- 0 0 0 0 0 0 0 c 0 0 0 0 0 0 0 0 0 0 0 0 0 0 0 0 0 0 0 0 -
- 0 0 0 0 0 0 0 0 0 0 0 0 0 0 0 0 0 0 0 0 0 0 0 0 0 0 0 0 -
- - 0 0 0 0 0 0 0 0 0 0 0 0 0 0 0 0 0 0 0 0 c 0 0 0 0 0 - -
- - - - 0 0 0 0 0 0 0 0 0 0 0 0 0 0 0 0 0 0 0 0 0 0 - - - -
12 0 0 <-> 12 29 4
13 0 0 <-> 13 29 4
14 0 0 <-> 14 29 4
15 0 0 <-> 15 29 4
16 0 0 <-> 16 29 4
17 0 0 <-> 17 29 4
0 12 6 <-> 29 12 2
0 13 6 <-> 29 13 2
0 14 6 <-> 29 14 2
0 15 6 <-> 29 15 2
0 16 6 <-> 29 16 2
0 17 6 <-> 29 17 2



