2
4
3 1
20 20
0 0 0 0 0 0 0 0 0 0 0 0 0 0 0 0 0 0 0 x
0 0 0 0 0 0 0 0 0 0 0 0 0 0 c 0 0 0 0 0
0 0 x 0 0 0 0 0 0 0 0 0 0 0 0 0 0 0 0 0
0 0 0 0 - - - - 0 1 2 0 - - - - 0 0 0 0
0 0 0 0 - - - - 0 2 1 0 - - - - 0 0 0 0
0 0 0 0 0 0 0 0 0 0 0 0 0 0 0 0 0 0 0 0
0 0 0 0 b 0 0 0 0 0 0 0 0 0 0 0 0 0 0 0
0 0 0 0 0 0 0 0 - - - - 0 0 0 x 0 0 0 0
0 i 0 0 0 0 0 0 - - - - 0 0 0 0 c 0 0 0
0 0 0 0 1 2 0 0 0 0 0 0 0 0 0 0 0 0 0 0
0 0 0 0 2 1 0 0 0 0 0 0 0 0 0 0 0 0 x 0
0 0 0 0 0 0 0 0 - - - - 0 i 0 0 0 0 0 0
0 0 0 0 0 0 0 0 - - - - 0 0 0 0 b 0 0 0
0 0 x 0 0 0 0 0 0 0 0 0 0 0 0 0 0 0 0 0
0 0 0 0 0 0 0 0 0 0 0 0 0 0 0 0 0 0 c 0
0 0 0 0 - - - - 0 2 1 0 - - - - 0 0 0 0
0 0 0 0 - - - - 0 1 2 0 - - - - 0 0 0 0
0 0 0 0 0 0 0 0 0 0 0 0 0 0 0 0 0 0 0 0
0 0 0 0 0 0 x 0 0 0 0 0 0 0 0 0 0 0 0 0
x 0 0 0 0 0 0 0 0 0 0 0 0 0 0 0 0 0 x 0
0 0 7 <-> 19 19 3
4 0 0 <-> 12 0 0
5 0 0 <-> 13 0 0
6 0 0 <-> 14 0 0
7 0 0 <-> 15 0 0
0 7 6 <-> 19 7 2
0 8 6 <-> 19 8 2
0 9 6 <-> 19 9 2
0 10 6 <-> 19 10 2
0 11 6 <-> 19 11 2
0 12 6 <-> 19 12 2
4 19 4 <-> 12 19 4
5 19 4 <-> 13 19 4
6 19 4 <-> 14 19 4
7 19 4 <-> 15 19 4


