2
0
0 0
18 18
i i i i i i i i i i i i i i i i i i 
i 0 0 0 0 0 0 0 0 0 0 0 0 0 0 0 0 i 
i 0 i i i i i i i i i i i i i i 0 i 
i 0 i 0 0 0 0 0 0 0 0 0 0 0 0 i 0 i 
i 0 i 0 i i i i i i i i i i 0 i 0 i 
i 0 i 0 i 0 0 0 0 0 0 0 0 i 0 i 0 i 
i 0 i 0 i 0 i i i i i i 0 i 0 i 0 i 
i 0 i 0 i 0 i 0 0 0 0 i 0 i 0 i 0 i 
i 0 i 0 i 0 i 0 2 1 0 i 0 i 0 i 0 i 
i 0 i 0 i 0 i 0 1 2 0 i 0 i 0 i 0 i 
i 0 i 0 i 0 i 0 0 0 0 i 0 i 0 i 0 i 
i 0 i 0 i 0 i i i i i i 0 i 0 i 0 i 
i 0 i 0 i 0 0 0 0 0 0 0 0 i 0 i 0 i 
i 0 i 0 i i i i i i i i i i 0 i 0 i 
i 0 i 0 0 0 0 0 0 0 0 0 0 0 0 i 0 i 
i 0 i i i i i i i i i i i i i i 0 i 
i 0 0 0 0 0 0 0 0 0 0 0 0 0 0 0 0 i 
i i i i i i i i i i i i i i i i i i 
