3
0
0 0
19 19
i i i i i i i i i i i i i i i i i i i 
i 0 0 0 0 0 0 0 0 0 0 0 0 0 0 0 0 0 i 
i 0 i i i i i i i i i i i i i i i 0 i 
i 0 i 0 0 0 0 0 0 0 0 0 0 0 0 0 i 0 i 
i 0 i 0 i i i i i i i i i i i 0 i 0 i 
i 0 i 0 i 0 0 0 0 0 0 0 0 0 i 0 i 0 i 
i 0 i 0 i 0 i i i i i i i 0 i 0 i 0 i 
i 0 i 0 i 0 i 0 0 0 0 0 i 0 i 0 i 0 i 
i 0 i 0 i 0 i 0 1 2 3 0 i 0 i 0 i 0 i 
i 0 i 0 i 0 i 0 3 1 2 0 i 0 i 0 i 0 i 
i 0 i 0 i 0 i 0 1 2 3 0 i 0 i 0 i 0 i 
i 0 i 0 i 0 i 0 0 0 0 0 i 0 i 0 i 0 i 
i 0 i 0 i 0 i i i i i i i 0 i 0 i 0 i 
i 0 i 0 i 0 0 0 0 0 0 0 0 0 i 0 i 0 i 
i 0 i 0 i i i i i i i i i i i 0 i 0 i 
i 0 i 0 0 0 0 0 0 0 0 0 0 0 0 0 i 0 i 
i 0 i i i i i i i i i i i i i i i 0 i 
i 0 0 0 0 0 0 0 0 0 0 0 0 0 0 0 0 0 i 
i i i i i i i i i i i i i i i i i i i 
