4
10
4 2
23 48
- - - - - - - - - - - - - - - - 0 0 0 0 0 0 0 0 0 0 0 0 - - - - - - - - - - - - - - - - - - - - 
0 0 0 0 0 0 - - - - - - - 0 0 0 0 0 0 0 0 x x 0 0 0 0 0 0 0 - - - - - - 0 0 0 0 0 0 0 0 0 0 0 0 
0 0 0 0 0 0 - - - - - 0 0 0 0 0 0 0 0 0 0 x x 0 0 0 0 0 0 0 0 0 - - - - - 0 0 0 0 0 0 0 0 0 0 0 
0 0 0 0 0 0 - - - - 0 0 0 0 0 0 0 0 0 0 0 0 0 0 0 0 0 0 0 0 0 0 0 - - - 0 0 0 0 0 0 0 0 0 0 0 - 
0 0 0 0 0 0 0 - - 0 0 0 0 0 0 0 - - - 0 0 0 0 0 0 - - - - 0 0 0 0 0 - - 0 0 0 0 0 0 0 0 0 0 0 - 
- 0 0 0 0 0 0 - - 0 0 0 0 - - - - - - - 0 0 0 0 - - - - - - - - 0 0 0 - 0 0 0 0 0 0 0 0 0 0 0 - 
- 0 0 0 0 0 0 0 - 0 0 0 0 - - - - - - - 0 0 - 0 0 - - - - - - - 0 0 0 - 0 0 0 0 0 0 0 0 0 0 - - 
- 0 0 0 0 0 0 0 x 0 0 0 0 0 0 - - - - 0 - 0 - 0 0 - - - - - 0 0 0 0 0 x 0 0 0 0 0 0 0 0 0 0 - - 
- - 0 0 0 0 0 0 0 x 0 0 0 0 0 0 0 0 0 0 - 0 - - 0 0 0 0 0 0 0 0 0 0 x 0 0 0 0 0 0 0 0 0 0 - - - 
- - - 0 0 0 0 0 0 0 0 1 2 0 0 0 0 0 0 - - - - - - 0 0 0 0 0 0 4 3 0 0 0 0 0 0 0 0 0 0 0 - - - - 
- - - - 0 0 0 0 0 0 0 2 1 0 0 0 0 0 0 - - - - - - 0 0 0 0 0 0 3 4 0 0 0 0 0 0 0 0 0 - - - - - - 
- - - - - - 0 0 0 0 0 0 0 0 0 0 0 0 0 0 0 - - - 0 0 0 0 0 0 0 0 0 0 0 0 0 0 0 0 - - - - - - - - 
- - - - - - - - 0 0 0 0 0 0 0 0 0 0 0 0 0 0 0 0 0 0 0 0 0 0 0 0 0 0 0 0 0 - - - - - - - - - - - 
- - - - - - - - - - - - 0 0 0 0 0 0 0 0 0 0 0 0 0 0 0 0 0 0 0 0 0 0 - - - - - - - - - - - - - - 
- 0 0 0 - - - - - - - - - - 0 0 - - 0 - 0 0 - 0 - 0 - 0 - 0 0 - - - - - - - - - - 0 0 - - - - - 
0 0 0 0 0 0 0 0 - - - - - - 0 - - 0 0 - 0 - - 0 - 0 0 - 0 - 0 - - - - - - - - 0 0 0 0 0 0 - - - 
0 0 0 0 0 0 0 - - - - - - - - 0 0 0 0 0 0 0 0 0 0 0 0 0 0 0 - - - - - - - - - - 0 0 0 0 0 0 - - 
0 0 x x 0 0 0 0 0 0 0 0 0 0 0 0 0 0 0 0 0 0 - - 0 0 0 - 0 0 0 0 0 0 0 0 0 0 0 0 0 0 x x 0 0 - - 
- 0 x x 0 0 0 0 0 0 0 0 0 0 0 0 0 - 0 0 0 - - - - 0 0 0 - 0 0 0 0 0 0 0 0 0 0 0 0 0 x x 0 - - - 
0 0 x x 0 0 0 0 0 0 0 0 0 0 0 0 - 0 0 0 - - - - - - 0 0 0 - 0 0 0 0 0 0 0 0 0 0 0 0 x x 0 0 0 - 
- 0 0 0 0 0 - - - - - - - - - - 0 0 0 - - - - - - - - 0 0 0 - - - - - - - - - - 0 0 0 0 0 0 0 - 
- 0 0 0 0 0 0 - - - - - - 0 0 0 0 0 0 0 - - - - - 0 0 0 0 0 0 0 0 - - - - - - 0 0 0 0 0 0 0 0 - 
- - 0 0 - - - - - - - - - - 0 0 - 0 0 - - - - - - - 0 0 - 0 0 0 - - - - - - - - - 0 0 0 0 - - - 
