4
4
0 0
41 79
0 0 0 0 0 0 0 0 0 0 0 0 0 0 0 0 0 0 0 0 0 0 0 0 0 0 0 0 - - - - - - - - - - - 0 0 0 0 0 0 0 0 0 0 0 0 0 0 0 0 0 0 0 0 0 0 0 0 0 0 0 0 0 0 0 0 0 0 0 0 - c c c 
0 0 0 0 0 0 0 0 0 0 0 0 0 0 0 0 0 0 0 0 0 0 0 0 0 0 0 0 - - - - - - - - - - - 0 0 0 0 0 0 0 0 0 0 0 0 0 0 0 0 0 0 0 0 0 0 0 0 0 0 0 0 0 0 0 0 0 0 0 0 - c c c 
0 0 0 0 0 0 0 0 0 0 0 0 0 0 0 0 0 0 0 0 0 0 0 0 0 0 0 0 0 - - - - - - - - - 0 0 0 0 0 0 0 0 0 0 0 0 0 0 0 0 0 0 0 0 0 0 0 0 0 0 0 0 0 0 0 0 0 0 0 0 0 - c c c 
0 0 0 0 0 0 0 0 0 0 0 0 0 0 0 0 0 0 0 0 0 0 0 0 0 0 0 0 0 - - - - - - - - - 0 0 0 0 0 0 0 0 0 0 0 0 0 0 0 0 0 0 0 0 0 0 0 0 0 0 0 0 0 0 - - - - - - - - - - - 
0 0 0 0 - - - - 0 0 0 1 2 0 0 0 - - - - - - - - 0 0 0 0 0 - - - - - - - - - 0 0 0 0 0 0 0 0 0 - - - - - - 0 0 0 0 - - - - 0 0 0 0 0 0 0 0 - - - - - - - - - - 
0 0 0 0 - - - - 0 0 0 2 1 0 0 0 - - - - - - - - 0 0 0 0 0 0 - - - - - - - 0 0 0 0 0 - 0 0 0 0 - - - - - - 0 0 0 0 - - - - 0 0 0 - 0 0 0 0 - - - - - - - - - - 
0 0 0 0 - - - - 0 0 0 0 0 0 0 0 - - - - - - - - - 0 0 0 0 0 - - - - - - - 0 0 0 0 0 - 0 0 0 0 - - - - - - 0 0 0 0 - - - - 0 0 0 - - 0 0 0 0 - - - - - - - - - 
0 0 0 0 0 0 0 0 0 0 0 0 0 0 0 0 - - - - - - - - - 0 0 0 0 0 - - - - - - 0 0 0 0 0 - - 0 0 0 0 - - - - - - 0 0 0 0 0 0 0 0 0 0 0 - - 0 0 0 0 - - - - - - 0 0 0 
0 0 0 0 0 0 0 0 0 0 0 0 0 0 0 0 0 0 0 0 0 0 0 - - - 0 0 0 0 0 - - - - - 0 0 0 0 0 - - 0 0 0 0 0 0 0 0 0 0 0 3 4 0 0 0 0 0 0 0 0 - - - 0 0 0 0 - - - - - 0 0 0 
0 0 0 0 0 0 0 0 0 0 0 0 0 0 0 0 0 0 0 0 0 0 0 - - - 0 0 0 0 0 - - - - 0 0 0 0 0 - - - 0 0 0 0 0 0 0 0 0 0 0 4 3 0 0 0 0 0 0 0 0 - - - - 0 0 0 0 - - - - 0 0 0 
0 0 0 0 0 0 - - - - - - 0 0 0 0 0 0 0 0 0 0 0 - - - - 0 0 0 0 0 - - - 0 0 0 0 0 - - - 0 0 0 0 0 0 0 0 0 0 0 0 0 0 0 - - - - - - - - - - 0 0 0 0 - - - - 0 0 0 
0 0 0 0 0 0 - - - - - - 0 0 0 0 0 0 0 0 0 0 0 - - - - 0 0 0 0 0 - - 0 0 0 0 0 - - - - 0 0 0 0 0 0 0 0 0 0 0 0 0 0 0 0 - - - - - - - - - - 0 0 0 0 - - - 0 0 0 
0 0 0 0 0 0 0 - - - - - 0 0 0 0 - - - - - - - - - - - - 0 0 0 0 0 - 0 0 0 0 0 - - - - 0 0 0 0 - - - - - - 0 0 0 0 0 0 0 - - - - - - - - - 0 0 0 0 - - - 0 0 0 
0 0 0 0 0 0 0 0 - - - - 0 0 0 0 - - - - - - - - - - - - 0 0 0 0 0 0 0 0 0 0 - - - - - 0 0 0 0 - - - - - - 0 0 0 0 0 0 0 0 - - - - - - - - - 0 0 0 0 - - 0 0 0 
0 0 0 0 0 0 0 0 0 - - - 0 0 0 0 - - - - - - - - - - - - - 0 0 0 0 0 0 0 0 0 - - - - - 0 0 0 0 - - - - - - 0 0 0 0 0 0 0 0 0 - - - - - - - - - 0 0 0 0 - 0 0 0 
0 0 0 0 - 0 0 0 0 0 - - 0 0 0 0 - - - - - - - - - - - - - 0 0 0 0 0 0 0 0 - - - - - - 0 0 0 0 - - - - - - 0 0 0 0 - 0 0 0 0 0 - - - - - - - - - 0 0 0 0 0 0 0 
0 0 0 0 - - 0 0 0 0 0 - 0 0 0 0 0 0 0 0 0 0 0 - - - - - - - 0 0 0 0 0 0 0 - - - - - - 0 0 0 0 0 0 0 0 0 0 0 0 0 0 - - 0 0 0 0 0 - - - - - - - - - 0 0 0 0 0 0 
0 0 0 0 - - - 0 0 0 0 0 0 0 0 0 0 0 0 0 0 0 0 - - - - - - - 0 0 0 0 0 0 - - - - - - - 0 0 0 0 0 0 0 0 0 0 0 0 0 0 - - - 0 0 0 0 0 0 0 0 0 0 0 0 0 0 0 0 0 0 0 
0 0 0 0 - - - - 0 0 0 0 0 0 0 0 0 0 0 0 0 0 0 - - - - - - - 0 0 0 0 0 0 - - - - - - - 0 0 0 0 0 0 0 0 0 0 0 0 0 0 - - - - 0 0 0 0 0 0 0 0 0 0 0 0 0 0 0 0 0 0 
0 0 0 0 - - - - - 0 0 0 0 0 0 0 0 0 0 0 0 0 0 - - - - - - - - 0 0 0 0 0 - - - - - - - 0 0 0 0 0 0 0 0 0 0 0 0 0 0 - - - - - 0 0 0 0 0 0 0 0 0 0 0 0 0 0 0 0 0 
0 0 0 0 - - - - - - 0 0 0 0 0 - - - - - - - - - - - - - - - - 0 0 0 0 - - - - - - - - - - - - - - - - - - 0 0 0 0 - - - - - - 0 0 0 0 0 - - - - - - - - - - - 
- - - - - - - - - - - - - - - - - - - - - - - - - - - - - - - - - - - - - - - - - - - - - - - - - - - - - - - - - - - - - - - - - - - - - - - - - - - - - - - 
- - - - - - - - - - - - - - - - - - - - - - - - - - - - - - - - - - - - - - - - - - - - - - - - - - - - - - - - - - - - - - - - - - - - - - - - - - - - - - - 
- - - - - - - - - - - - - - - - - - - - - - - - - - - - - - - - - - - - - - - - - - - - - - - - - - - - - - - - - - - - - - - - - - - - - - - - - - - - - - - 
- - - - - - - - - - - - - - - - - - - - - - - - - - - - 0 0 0 0 - - - - - - - - - - - - - - - 0 0 - - - - - - 0 0 0 0 0 0 0 0 0 0 0 - - - - - - - - - - - - - 
- - - - - - - - - - - - - 0 0 0 0 - - - - - - - - - - 0 - - - - 0 - - - - - - - - - - - - - 0 - 0 - - - - - - 0 - - - - - - - - - - - - - - - - - - - - - - - 
- - - - - - - - - - - - 0 - - - - 0 - - - - - - - - 0 - - - - - - 0 - - - - - - - - - - - 0 - - 0 - - - - - - 0 - - - - - - - - - - - - - - - - - - - - - - - 
- - - - - - - - - - - 0 - - - - - - 0 - - - - - - 0 - - - - - - - - 0 - - - - - - - - - 0 - - - 0 - - - - - - 0 - - - - - - - - - - - - - - - - - - - - - - - 
- - - - - - - - - - - - - - - - - - 0 - - - - - - 0 - - - - - - - - 0 - - - - - - - - 0 - - - - 0 - - - - - - 0 - - - - - - - - - - - - - - - - - - - - - - - 
- - - - - - - - - - - - - - - - - - - 0 - - - - 0 - - - - - - - - - - 0 - - - - - - 0 - - - - - 0 - - - - - - 0 - - - 0 0 0 0 - - - - - - - - - - - - - - - - 
- - - - - - - - - - - - - - - - - - - 0 - - - - 0 - - - - - - - - - - 0 - - - - - 0 - - - - - - 0 - - - - - - 0 - 0 0 - - - - 0 0 - - - - - - - - - - - - - - 
- - - - - - - - - - - - - - - - - - - 0 - - - - 0 - - - - - - - - - - 0 - - - - - - - - - - - - 0 - - - - - - 0 0 - - - - - - - - 0 - - - - - - - - - - - - - 
- - - - - - - - - - - - - - - - - - - 0 - - - - 0 - - - - - - - - - - 0 - - - - - - - - - - - - 0 - - - - - - - - - - - - - - - - 0 - - - - - - - - - - - - - 
- - - - - - - - - - - - - - - - - - 0 - - - - - 0 - - - - - - - - - - 0 - - - - - - - - - - - - 0 - - - - - - - - - - - - - - - - - 0 - - - - - - - - - - - - 
- - - - - - - - - - - - - 0 0 - - - 0 - - - - - 0 - - - - - - - - - - 0 - - - - - - - - - - - - 0 - - - - - - - - - - - - - - - - - 0 - - - - - - - - - - - - 
- - - - - - - - - - - - 0 - - 0 0 - 0 - - - - - 0 - - - - - - - - - - 0 - - - - - - - - - - - - 0 - - - - - - - - - - - - - - - - - 0 - - - - - - - - - - - - 
- - - - - - - - - - - 0 - - - - - 0 - - - - - - - 0 - - - - - - - - 0 - - - - - - - - - - - - - 0 - - - - - - - - - - - - - - - - - 0 - - - - - - - - - - - - 
- - - - - - - - - - - 0 - - - - - 0 0 - - - - - - 0 - - - - - - - - 0 - - - - - - - - - - - - - 0 - - - - - - - - - - - - - - - - 0 - - - - - - - - - - - - - 
- - - - - - - - - - - - 0 - - - 0 - - 0 - - - - - - 0 - - - - - - 0 - - - - - - - - - - - - - - 0 - - - - - - 0 - - - - - - - - - 0 - - - - - - - - - - - - - 
- - - - - - - - - - - - - 0 0 0 - - - - 0 - - - - - - 0 - - - - 0 - - - - - - - - - - - - - - - 0 - - - - - - - 0 - - - - - - 0 0 - - - - - - - - - - - - - - 
- - - - - - - - - - - - - - - - - - - - - - - - - - - - 0 0 0 0 - - - - - - - - - - - - - - - - 0 - - - - - - - - 0 0 0 0 0 0 - - - - - - - - - - - - - - - - 
