4
1
1 2
29 34
- - - - - - - - - - - - - - - - - - - - - - - - - - - - - - - - - - 
- - - - - - - - - - - - - - - - - - - - - - - - - - - - - - - - - - 
- - - - - - - - x 0 - - - 0 x - - c 0 0 0 0 0 0 b - - - - - - - - - 
- - - - - - - - 0 0 - - - 0 0 - - 0 0 0 0 0 0 0 0 - - - - - - - - - 
- - - - - - - - 0 0 - - - 0 b - - 0 0 - - - - 0 0 - - - - - - - - - 
- - - - - - - - 0 0 - - - 0 0 - - 0 0 - - - 0 0 0 - - - - - - - - - 
- - - - - - - - 0 0 0 0 0 0 0 - - 0 0 - - 0 0 0 - - - - - - - - - - 
- - - - - - - - b 0 0 0 c 0 0 - - - - - - 0 0 - - - - - - - - - - - 
- - - - - - - - - - - - - 0 0 - - - - - 0 i 0 - - - - - - - - - - - 
- - - - - - - - - - - - - 0 0 - - - - - 0 0 - - - - - - - - - - - - 
- - - - - - - - - - - - - 0 0 - - - - 0 0 0 - - - - - - - - - - - - 
- - - - - - - - - - - - - 0 0 - - - x b 0 - - - - - - - - - - - - - 
- - - - - - - - - - - - - 0 0 - - 0 0 0 0 0 0 0 0 - - - - - - - - - 
- - - - - - - - - - - - - 0 0 - - 0 0 0 0 0 0 0 0 - - - - - - - - - 
- - - - - - - - - - - - - - - - - - - - - - - - - - - - - - - - - - 
- - - - - - - - b 0 0 0 0 0 0 0 0 0 0 0 0 0 0 0 0 0 b - - - - - - - 
- - - - - - - - 0 0 0 0 0 0 0 0 0 0 0 0 0 0 0 0 0 0 0 - - - - - - - 
- - - - - - - - 0 0 0 0 0 0 0 0 0 0 0 0 0 0 0 0 0 0 0 - - - - - - - 
- - - - - - - - 0 0 0 0 0 0 0 0 i 0 0 0 0 0 0 0 0 0 0 - - - - - - - 
- - - - - - - - 0 0 0 0 0 0 0 0 0 0 0 0 0 0 0 0 0 0 0 - - - - - - - 
- - - - - - - - 0 0 0 0 0 0 0 0 0 0 0 0 0 0 0 0 0 0 0 - - - - - - - 
- 0 0 0 0 0 0 0 0 0 0 0 0 0 0 0 0 0 0 0 0 0 0 0 0 0 0 0 0 0 0 0 0 0 
- 0 0 0 0 0 0 0 0 0 0 0 0 0 0 0 0 0 0 0 0 0 0 0 0 0 0 0 0 0 0 0 0 0 
- 0 0 0 0 0 0 0 0 0 0 0 0 0 0 0 0 0 0 0 0 0 0 0 0 0 0 0 0 0 0 0 0 0 
- 0 0 1 2 0 0 0 0 0 0 4 3 0 0 0 0 0 0 0 2 3 0 0 0 0 0 0 0 3 4 0 0 0 
- 0 0 2 1 0 0 0 0 0 0 3 4 0 0 0 0 0 0 0 3 2 0 0 0 0 0 0 0 4 3 0 0 0 
- 0 0 0 0 0 0 0 0 0 0 0 0 0 0 0 0 0 0 0 0 0 0 0 0 0 0 0 0 0 0 0 0 0 
- 0 0 0 0 0 0 0 0 0 0 0 0 0 0 0 0 0 0 0 0 0 0 0 0 0 0 0 0 0 0 0 0 0 
- 0 0 0 0 0 0 0 0 0 0 0 0 0 0 0 0 i 0 0 0 0 0 0 0 0 0 0 0 0 0 0 0 0 
24 15 0 <-> 24 13 4
22 15 0 <-> 22 13 4
20 15 0 <-> 20 13 4
18 15 0 <-> 18 13 4
14 15 0 <-> 14 13 4
33 21 1 <-> 24 2 1
1 21 7 <-> 14 2 1
33 28 3 <-> 26 15 1
1 28 5 <-> 8 15 7
24 5 3 <-> 17 6 5
18 6 4 <-> 18 11 0
24 12 2 <-> 14 12 2
14 10 2 <-> 11 15 7
12 15 0 <-> 8 7 4
