2
2
0 0
27 47
0 0 0 - - - - - - - - - - - - - - - - - - - - - - - - - - - - - - 0 - - - - - - - - - - - - - 
0 0 2 1 - - - - - - - - 0 0 0 - - - - - - - - - - - - - - - 0 0 0 0 0 0 0 - - - - - - - - - - 
- 0 1 2 0 0 0 0 0 0 0 0 0 0 0 0 0 x - - - - - - - - - 0 0 0 0 0 0 0 0 0 0 0 0 0 - - - - - - - 
0 0 2 1 - - - - - - - - 0 0 0 - - - - - - - - - - 0 0 0 0 0 0 0 - 0 - 0 0 0 0 0 0 0 - - - - - 
0 0 0 - - - - - - - - - - - - - - - - - - - - - 0 0 0 0 0 - - - - 0 - - - - 0 0 0 0 0 - - - - 
- - - - - - - - - - - - - - - - - - - - - - - 0 0 0 0 - - i - - - 0 - - - i - - 0 0 0 0 - - - 
- - - - - - - - - - - - - - - - - - - - - - - 0 0 0 0 - - - 0 0 0 0 0 0 0 - - - 0 0 0 0 - - - 
0 0 0 - - - - - - - - - - - - - - - - - - - 0 0 0 - - 0 - 0 0 0 0 0 0 0 0 0 - 0 - - 0 0 0 - - 
0 0 1 2 - - - - - - - - 0 0 0 - - - - - - - 0 0 0 - - - 0 0 0 0 - 0 - 0 0 0 0 - - - 0 0 0 - - 
- 0 2 1 0 0 0 0 0 0 0 0 0 0 0 0 0 x - - - - 0 0 - i - 0 0 0 - - - 0 - - - 0 0 0 - i - 0 0 - - 
0 0 1 2 - - - - - - - - 0 0 0 - - - - - - 0 0 0 - - 0 0 0 - i - - 0 - - i - 0 0 0 - - 0 0 0 - 
0 0 0 - - - - - - - - - - - - - - - - - - 0 0 0 - - 0 0 0 - - x - 0 - x - - 0 0 0 - - 0 0 0 - 
- - - - - - - - i - - - - - - - - - - - - 2 1 - - - 0 0 - - - - b b b - - - - 0 0 - - - 1 2 - 
- - - - - - - - - - - - - - - - - - - - 0 1 2 0 0 0 0 0 0 0 0 0 b b b 0 0 0 0 0 0 0 0 0 2 1 0 
0 0 0 - - - - - - - - - - - - - - - - - - 2 1 - - - 0 0 - - - - b b b - - - - 0 0 - - - 1 2 - 
0 0 2 1 - - - - - - - - 0 0 0 - - - - - - 0 0 0 - - 0 0 0 - - x - 0 - x - - 0 0 0 - - 0 0 0 - 
- 0 1 2 0 0 0 0 0 0 0 0 0 0 0 0 0 x - - - 0 0 0 - - 0 0 0 - i - - 0 - - i - 0 0 0 - - 0 0 0 - 
0 0 2 1 - - - - - - - - 0 0 0 - - - - - - - 0 0 - i - 0 0 0 - - - 0 - - - 0 0 0 - i - 0 0 - - 
0 0 0 - - - - - - - - - - - - - - - - - - - 0 0 0 - - - 0 0 0 0 - 0 - 0 0 0 0 - - - 0 0 0 - - 
- - - - - - - - - - - - - - - - - - - - - - 0 0 0 - - 0 - 0 0 0 0 0 0 0 0 0 - 0 - - 0 0 0 - - 
- - - - - - - - - - - - - - - - - - - - - - - 0 0 0 0 - - - 0 0 0 0 0 0 0 - - - 0 0 0 0 - - - 
- - - - - - - - - - - - - - - - - - - - - - - 0 0 0 0 - - i - - - 0 - - - i - - 0 0 0 0 - - - 
- - - - - - - - - - - - - - - - - - - - - - - - 0 0 0 0 0 - - - - 0 - - - - 0 0 0 0 0 - - - - 
- - - - - - - - - - - - - - - - - - - - - - - - - 0 0 0 0 0 0 0 - 0 - 0 0 0 0 0 0 0 - - - - - 
- - - - - - - - - - - - - - - - - - - - - - - - - - - 0 0 0 0 0 0 0 0 0 0 0 0 0 - - - - - - - 
- - - - - - - - - - - - - - - - - - - - - - - - - - - - - - 0 0 0 0 0 0 0 - - - - - - - - - - 
- - - - - - - - - - - - - - - - - - - - - - - - - - - - - - - - - 0 - - - - - - - - - - - - - 
17 2 2 <-> 33 12 7
17 16 2 <-> 33 14 5
17 9 2 <-> 32 13 7
0 4 4 <-> 0 7 0
1 4 4 <-> 1 7 0
2 4 4 <-> 2 7 0
0 11 4 <-> 0 14 0
1 11 4 <-> 1 14 0
2 11 4 <-> 2 14 0
3 3 4 <-> 3 8 0
3 10 4 <-> 3 15 0
4 9 4 <-> 4 16 0
4 9 0 <-> 4 2 4
5 2 4 <-> 5 9 0
5 9 4 <-> 5 16 0
6 16 0 <-> 6 9 4
6 9 0 <-> 6 2 4
7 2 4 <-> 7 9 0
7 9 4 <-> 7 16 0
8 2 4 <-> 8 9 0
8 9 4 <-> 8 16 0
9 16 0 <-> 9 9 4
9 9 0 <-> 9 2 4
10 2 4 <-> 10 9 0
10 9 4 <-> 10 16 0
11 16 0 <-> 11 9 4
11 9 0 <-> 11 2 4
12 3 4 <-> 12 8 0
12 10 4 <-> 12 15 0
13 10 4 <-> 13 15 0
14 10 4 <-> 14 15 0
13 8 0 <-> 13 3 4
14 3 4 <-> 14 8 0
15 2 4 <-> 17 9 0
17 2 4 <-> 15 9 0
15 16 0 <-> 17 9 4
15 9 4 <-> 17 16 0
20 13 6 <-> 46 13 2
33 0 2 <-> 33 26 6
33 0 6 <-> 33 26 2
20 13 0 <-> 46 13 4
46 13 0 <-> 20 13 4
37 2 1 <-> 29 24 5
29 2 7 <-> 37 24 3
44 17 3 <-> 22 9 7
22 17 5 <-> 44 9 1
42 4 1 <-> 24 22 5
24 4 7 <-> 42 22 3
27 3 7 <-> 39 23 3
39 3 1 <-> 27 23 5
23 19 5 <-> 43 7 1
23 7 7 <-> 43 19 3
40 15 2 <-> 43 15 6
43 11 6 <-> 40 11 2
35 3 4 <-> 35 6 0
31 3 4 <-> 31 6 0
23 11 2 <-> 26 11 6
23 15 2 <-> 26 15 6
31 23 0 <-> 31 20 4
26 22 1 <-> 29 19 5
24 20 1 <-> 27 17 5
40 22 7 <-> 37 19 3
42 20 7 <-> 39 17 3
35 20 4 <-> 35 23 0
42 6 5 <-> 39 9 1
40 4 5 <-> 37 7 1
26 4 3 <-> 29 7 7
24 6 3 <-> 27 9 7
27 14 2 <-> 32 14 6
34 14 2 <-> 39 14 6
39 12 6 <-> 34 12 2
32 12 6 <-> 27 12 2
