2
2
0 0
32 40
- - - - - - - - - - - - - - - - - - - - - - - - - - - - - - - - - - - - - - - - 
- - - - - - - - - - - - - - - - - - - - - - - - - - - - - - - - - - - - - - - - 
- - - - - - - - - - - - - - - - - - - - - - - - - - - - - - - - - - - - - - - - 
- - - - - - - - - - - - - - - - - - - - - - - - - - - - - - - - - - - - - - - - 
- - - - - - - - - - - - - - - - - - - - - - - - - - - - - - - - - - - - - - - - 
- - - - - - - - - - - - - - - - - - - - - - - - - - - - - - - - - - - - - - - - 
- - - - - - 0 0 0 0 0 0 0 0 0 0 0 0 0 0 0 0 0 0 0 0 0 0 0 0 0 0 0 0 0 0 0 0 0 0 
- - - - - - 0 0 0 0 0 0 0 0 0 0 0 0 0 0 0 0 0 0 0 0 0 0 0 0 0 0 0 0 0 0 0 0 0 0 
- - - - - - 0 0 0 0 0 0 0 0 0 0 0 0 0 0 0 0 0 0 0 0 0 0 0 0 0 0 0 0 0 0 0 0 0 0 
- - - - - - 0 0 0 - - - - - - 0 0 0 0 0 0 0 0 0 0 0 0 0 0 0 0 - - - - - - 0 0 0 
- - - - - - 0 0 0 - 0 0 0 0 - 0 0 0 0 0 0 0 0 0 0 0 0 0 0 0 0 - 0 0 0 0 - 0 0 0 
- - - - - - 0 0 0 - 0 2 1 0 - 0 0 0 0 0 0 2 1 0 0 0 0 0 0 0 0 - 0 2 1 0 - 0 0 0 
- - - - - - 0 0 0 - 0 1 2 0 - 0 0 0 0 0 0 1 2 0 0 0 0 0 0 0 0 - 0 1 2 0 - 0 0 0 
- - - - - - 0 0 0 - 0 0 0 0 - 0 0 0 0 0 0 0 0 0 0 0 0 0 0 0 0 - 0 0 0 0 - 0 0 0 
- - - - - - 0 0 0 - - - - - - 0 0 - - - - - - - - - - - - 0 0 - - - - - - 0 0 0 
- - - - - - 0 0 0 0 0 0 0 0 0 0 0 - 0 0 0 0 0 0 0 0 0 0 - 0 0 0 0 0 0 0 0 0 0 0 
- - - - - - 0 0 0 0 0 0 0 0 0 0 0 - 0 0 0 0 0 0 0 0 0 0 - 0 0 0 0 0 0 0 0 0 0 0 
- - - - - - 0 0 0 0 0 0 0 0 0 0 0 - 0 0 0 0 0 0 0 0 0 0 - 0 0 0 0 0 0 0 0 0 0 0 
- - - - - - 0 0 0 0 0 0 0 0 0 0 0 - 0 0 0 0 b i 0 0 0 0 - 0 0 0 0 0 0 0 0 0 0 0 
- - - - - - 0 0 2 1 c 0 0 0 0 0 0 - 0 0 0 0 i b 0 0 0 0 - 0 0 0 0 0 0 c 2 1 0 0 
- - - - - - 0 0 1 2 0 0 0 0 0 0 0 - 0 0 0 0 0 0 0 0 0 0 - 0 0 0 0 0 0 0 1 2 0 0 
- - - - - - 0 0 0 0 0 0 0 0 0 0 0 - 0 0 0 0 0 0 0 0 0 0 - 0 0 0 0 0 0 0 0 0 0 0 
- - - - - - 0 0 0 0 0 0 0 0 0 0 0 - 0 0 0 0 0 0 0 0 0 0 - 0 0 0 0 0 0 0 0 0 0 0 
- - - - - - 0 0 0 - - - - - - 0 0 - - - - - - - - - - - - 0 0 - - - - - - 0 0 0 
- - - - - - 0 0 0 - 0 0 0 0 - 0 0 0 0 0 0 0 0 0 0 0 0 0 0 0 0 - 0 0 0 0 - 0 0 0 
- - - - - - 0 0 0 - 0 2 1 0 - 0 0 0 0 0 0 0 0 0 0 0 0 0 0 0 0 - 0 1 2 0 - 0 0 0 
- - - - - - 0 0 0 - 0 1 2 0 - 0 0 0 0 0 0 0 0 0 0 0 0 0 0 0 0 - 0 2 1 0 - 0 0 0 
- - - - - - 0 0 0 - 0 0 0 0 - 0 0 0 0 0 0 2 1 0 0 0 0 0 0 0 0 - 0 0 0 0 - 0 0 0 
- - - - - - 0 0 0 - - - - - - 0 0 0 0 0 0 1 2 0 0 0 0 0 0 0 0 - - - - - - 0 0 0 
- - - - - - 0 0 0 0 0 0 0 0 0 0 0 0 0 0 0 0 0 0 0 0 0 0 0 0 0 0 0 0 0 0 0 0 0 0 
- - - - - - 0 0 0 0 0 0 0 0 0 0 0 0 0 0 0 0 0 0 0 0 0 0 0 0 0 0 0 0 0 0 0 0 0 0 
- - - - - - 0 0 0 0 0 0 0 0 0 0 0 0 0 0 0 0 0 0 0 0 0 0 0 0 0 0 0 0 0 0 0 0 0 0 
13 24 0 <-> 13 13 4
13 13 2 <-> 32 13 6
13 24 2 <-> 32 24 6
32 13 4 <-> 32 24 0
10 10 7 <-> 35 27 3
10 27 5 <-> 35 10 1
10 24 0 <-> 10 22 4
10 13 4 <-> 10 15 0
35 24 0 <-> 35 22 4
35 15 0 <-> 35 13 4
6 6 7 <-> 18 15 7
6 31 5 <-> 18 22 5
39 31 3 <-> 27 22 3
39 6 1 <-> 27 15 1
32 10 6 <-> 30 10 2
13 10 2 <-> 15 10 6
13 27 2 <-> 15 27 6
30 27 2 <-> 32 27 6
27 18 2 <-> 29 18 6
22 15 0 <-> 22 13 4
16 19 2 <-> 18 19 6
23 24 0 <-> 23 22 4
