3
3
2 2
15 36
- 0 x 0 0 0 0 0 0 0 0 0 0 0 0 0 0 0 0 0 0 0 0 0 0 0 0 0 0 0 0 0 0 x 0 - 
0 0 0 2 3 0 0 0 0 0 0 c 0 0 0 0 0 2 1 0 0 0 0 0 0 0 0 0 0 0 0 3 1 0 0 0 
0 0 0 3 2 0 0 0 0 0 0 0 0 0 0 0 0 1 2 0 0 0 0 0 0 0 0 0 0 0 0 1 3 0 0 0 
0 0 0 0 0 0 0 0 0 b 0 0 b 0 0 0 0 0 0 0 0 0 0 0 0 0 0 0 0 0 b b b 0 0 0 
0 0 0 - - - 0 0 0 - - - 0 0 0 - - - 0 0 - 0 0 0 0 0 - 0 0 0 - - - 0 0 0 
0 x 0 0 - 0 0 0 0 - 0 0 - 0 0 0 - 0 0 0 - - 0 0 0 - - 0 0 - 0 0 0 0 x 0 
0 0 0 0 - 0 x x 0 - 0 0 - 0 0 0 - 0 0 0 - 0 - 0 - 0 - 0 0 - 0 0 0 0 0 0 
0 0 0 0 - 0 c c 0 - - - 0 0 0 0 - 0 0 0 - 0 0 - 0 0 - 0 0 0 - - 0 0 0 0 
0 0 0 0 - 0 x x 0 - 0 0 - 0 0 0 - 0 0 0 - 0 0 0 0 0 - 0 0 0 0 0 - 0 0 0 
0 x 0 0 - 0 0 0 0 - 0 0 - 0 0 0 - 0 0 0 - 0 0 i 0 0 - 0 0 0 0 0 - 0 x 0 
0 0 0 - - - 0 0 0 - - - 0 0 0 - - - 0 0 - 0 0 0 0 0 - 0 0 - - - 0 0 0 0 
0 0 0 0 0 0 0 0 0 b 0 0 b 0 0 0 0 0 0 0 0 0 0 0 0 0 0 0 0 b b b 0 0 0 0 
0 0 0 1 2 0 0 0 0 0 0 0 0 0 0 0 0 1 3 0 0 0 0 0 0 0 0 0 0 0 0 2 3 0 0 0 
0 0 0 2 1 0 0 0 0 0 0 c 0 0 0 0 0 3 1 0 0 0 0 0 0 0 0 0 0 0 0 3 2 0 0 0 
- 0 x 0 0 0 0 0 0 0 0 0 0 0 0 0 0 0 0 0 0 0 0 0 0 0 0 0 0 0 0 0 0 x 0 - 
30 3 4 <-> 29 11 0
31 3 4 <-> 30 11 0
32 3 4 <-> 31 11 0
27 4 6 <-> 19 4 2
27 5 6 <-> 19 5 2
27 6 6 <-> 19 6 2
27 10 6 <-> 19 10 2
27 9 6 <-> 19 9 2
27 8 6 <-> 19 8 2
9 3 4 <-> 11 6 2
9 11 0 <-> 11 8 2
15 11 1 <-> 17 3 5
17 11 7 <-> 15 3 3
3 5 1 <-> 5 5 7
3 9 3 <-> 5 9 5
10 6 6 <-> 8 6 2
10 8 6 <-> 8 8 2
5 9 4 <-> 5 11 0
3 11 0 <-> 3 9 4
5 3 4 <-> 5 5 0
3 3 4 <-> 3 5 0
