4
2
2 2
36 30
- - - - - - - - - - - - - - - - - - - - - - - - - - - - - - 
- - - - - - - - - - - - - - - 0 - - - - - - - - - - - - - - 
- - - - - - - - - - - - - - 0 0 0 - - - - - - - - - - - - - 
- - - - - - - - - - - - - 0 0 0 0 0 - - - - - - - - - - - - 
- - - - - - - - - - - - 0 0 0 0 0 0 0 - - - - - - - - - - - 
- - - - - - - - - - - 0 0 0 0 0 0 0 0 0 - - - - - - - - - - 
- - - - - - - - - - 0 0 0 0 0 0 0 0 0 0 0 - - - - - - - - - 
- - - - - - - - - 0 0 0 0 0 - - - 0 0 0 0 0 - - - - - - - - 
- - - - - - - - 0 0 0 0 0 0 - - - 0 0 0 0 0 0 - - - - - - - 
- - - - - - - 0 0 0 0 0 0 0 - - - 0 0 0 0 0 0 0 - - - - - - 
- - - - - - 0 0 0 0 0 0 0 0 0 0 0 0 0 0 0 0 0 0 0 - - - - - 
- - - - - 0 0 0 0 0 0 2 1 0 0 0 0 0 4 3 0 0 0 0 0 0 - - - - 
- - - - 0 0 0 0 0 0 0 1 2 0 0 0 0 0 3 4 0 0 0 0 0 0 0 - - - 
- - - 0 0 0 0 0 0 0 0 0 0 0 0 0 0 0 0 0 0 0 0 0 0 0 0 0 - - 
- - 0 0 0 0 0 b 0 0 0 0 0 0 0 0 0 0 0 0 0 0 0 0 0 i 0 0 0 - 
- 0 0 0 i 0 0 0 0 0 0 0 b 0 0 0 0 0 0 0 0 0 0 b 0 0 0 0 0 0 
- - - 0 0 0 0 0 0 0 0 0 0 0 0 0 0 0 0 0 0 0 0 0 0 0 0 0 - - 
- - - 0 0 0 0 - - - - - - 0 0 0 0 0 - - - - - - 0 b 0 0 - - 
- - - 0 b 0 0 - - - - - - 0 0 b 0 0 - - - - - - 0 0 0 0 - - 
- - - 0 0 0 0 - - - - - - 0 0 0 0 0 - - - - - - 0 0 i 0 - - 
- - - 0 0 0 0 0 0 0 0 0 0 0 0 0 0 0 0 0 0 0 0 0 0 0 0 0 - - 
- - - 0 0 0 0 i 0 0 0 0 0 0 0 0 i 0 0 0 0 0 0 0 0 0 0 0 - - 
- - - 0 0 0 0 0 0 0 0 b 0 0 0 0 0 0 0 0 0 c 0 0 b 0 0 0 - - 
- - - 0 0 0 0 0 0 c 0 0 0 0 0 0 0 0 0 0 0 0 0 0 0 0 0 0 - - 
- - - 0 0 b 0 - - - - - - 0 0 0 b 0 - - - - - - 0 0 0 0 - - 
- - - 0 0 0 0 - - - - - - 0 0 0 0 0 - - - - - - 0 0 0 0 - - 
- - - 0 0 0 0 - - - - - - 0 0 0 0 0 - - - - - - 0 0 b 0 - - 
- - - 0 c 0 0 0 0 0 0 0 0 0 0 0 0 0 0 0 0 0 0 0 0 0 0 0 - - 
- - - 0 0 0 0 0 0 b 0 i 0 0 b 0 0 0 0 0 0 0 0 0 0 i 0 0 - - 
- - - 0 0 0 0 0 0 0 0 0 0 0 0 0 0 0 0 0 b 0 0 0 0 0 0 0 - - 
- - - 0 i 0 0 0 0 0 0 0 0 0 0 0 0 0 c 0 0 0 0 0 0 0 0 0 - - 
- - - 0 0 0 0 - - - 0 0 0 0 - - - 0 0 0 0 - - - 0 0 0 0 - - 
- - - 0 0 0 0 - - - 0 0 0 0 - - - 0 0 0 0 - - - 0 0 b 0 - - 
- - - 0 0 b 0 - - - 0 b 0 0 i - - 0 0 b 0 - - - 0 0 0 0 - - 
- - - 0 0 0 0 0 0 0 0 0 0 0 - - - 0 0 0 0 0 0 0 0 0 0 0 - - 
- - - 0 0 0 0 0 0 0 0 0 0 0 - - - 0 0 0 0 0 0 0 0 0 0 0 - - 
14 10 0 <-> 14 6 4
15 6 4 <-> 15 10 0
16 6 4 <-> 16 10 0
7 20 0 <-> 7 16 4
8 20 0 <-> 8 16 4
9 20 0 <-> 9 16 4
10 20 0 <-> 10 16 4
11 16 4 <-> 11 20 0
12 20 0 <-> 12 16 4
18 20 0 <-> 18 16 4
19 20 0 <-> 19 16 4
20 20 0 <-> 20 16 4
21 20 0 <-> 21 16 4
22 20 0 <-> 22 16 4
23 20 0 <-> 23 16 4
7 27 0 <-> 7 23 4
8 27 0 <-> 8 23 4
9 27 0 <-> 9 23 4
10 27 0 <-> 10 23 4
11 27 0 <-> 11 23 4
12 27 0 <-> 12 23 4
18 27 0 <-> 18 23 4
19 27 0 <-> 19 23 4
20 27 0 <-> 20 23 4
21 27 0 <-> 21 23 4
22 27 0 <-> 22 23 4
23 27 0 <-> 23 23 4
7 34 0 <-> 7 30 4
8 34 0 <-> 8 30 4
9 34 0 <-> 9 30 4
21 34 0 <-> 21 30 4
22 34 0 <-> 22 30 4
23 34 0 <-> 23 30 4
13 31 2 <-> 17 31 6
13 32 2 <-> 17 32 6
14 33 2 <-> 17 33 6
13 34 2 <-> 17 34 6
13 35 2 <-> 17 35 6
